| | | | | | | | | |
| . | . . . | . . |
| . | . | . . . . |
| . . . | . | | . |
| . | . . . | . . |
| . . . | . | | . |
| . | | . . . | . |
| . . | . | . | | |
| . . | . | . . . |
| | | | | | | | | |